10000010100000100011
11011110101011111001
10000000101010000001
11111110101011001011
00000010101001101001
01111010101101101111
00010010100100000010
00111110101110111110
00010000101000110000
11011101101111110111
01000000001000000101
11011111111011111101
00000100010000001101
11110101011111100100
00010101010001101110
01010101010101100100
11000101010101110101
01011101010100000100
00000111010111111110
01110000000000000000
